#########################################################################################################
#@##*...................................................................................................#
#..####################################################################################################.#
##..##*#..............................................................................................#.#
#.#.........#.#*###*###*###*###*###*###*###*###*###*###*###*###*###*###*###*###*###*###*###*###*####..#.#
#.####.##.#.#.###*###*###*###*###*###*###*###*###*###*###*###*###*###*###*###*###*###*###*###*###*###*#.#
#.*..#....#.#.........................................................................................#.#
#.#######.#.###############################################################...........................#.#
#.#.......#...............................................................#..........................*#.#
#.#.#########.#########################################################################################.#
#.#.........#.#..............................#.#.#.......................................#............#.#
#.#########.#.##############################.#.#.#.#####################################.#.##########.#.#
#...........#..............................#.#.#.#.#*.*.................################.#..........#.#.#
#.#########.#.##############################.#.#.#.#*.*.................#................##########.#.#.#
#.#...*...#.#.#*.............................#.#.#.##################...#.#########################.#.#.#
#.#..***..#...##############################.#.#.#.....................?#...........................#.#.#
#.#...*...#.#.............................*#.#.#.####################################################.#.#
#.#.......#.#.##############################.#.#.#....................................................#.#
#.#.#######.#.#**............................#.#.#.##################################################.#.#
#.#.#.......#.##############################.#.#.#.#..................................................#.#
#.#.#######.#..............................#.#.#.#.#..................................................#.#
#.#.......#.################################.#.#.#.#..................................................#.#
#.#...................................................................................................#.#
#.#####################################################################################################.#
#.......................................................................................................#
#########################################################################################################