##########################################################################################################################
#@*??....................................................................................................................#
#***?....................................................................................................................#
#????....................................................................................................................#
#........................................................................................................................#
#........................................................................................................................#
#........................................................................................................................#
#........................................................................................................................#
#........................................................................................................................#
#........................................................................................................................#
#........................................................................................................................#
#........................................................................................................................#
#........................................................................................................................#
#........................................................................................................................#
#........................................................................................................................#
#........................................................................................................................#
#........................................................................................................................#
#........................................................................................................................#
#........................................................................................................................#
#........................................................................................................................#
#........................................................................................................................#
#........................................................................................................................#
#........................................................................................................................#
#........................................................................................................................#
#........................................................................................................................#
#........................................................................................................................#
#........................................................................................................................#
##########################################################################################################################
