##########################################################################################################################
#@....#*#*#*#*#*#*#*#*#*#*#*#*#*#*#*#*#*#*#*#*#*#*#*#*#*#*#*#*#*#*#*#*#*#*#*#*#*#*#*#*#*#*#*#*#*#*#*#*#*#*#*#*#*#*#*#*#**#
#........................................................................................................................#
#.##.###################################################################################################################.#
#.##.#...................................................................................................................#
#..#.#...................................................................................................................#
#..#.#...................................................................................................................#
#..#.#...................................................................................................................#
#..#.#...................................................................................................................#
#..#.#...................................................................................................................#
#..#.#...................................................................................................................#
#..#.#...................................................................................................................#
#..#.#...................................................................................................................#
#..#.#...................................................................................................................#
#..#.#...................................................................................................................#
#..#.#...................................................................................................................#
#..#.#...................................................................................................................#
#..#.#...................................................................................................................#
#..#.#...................................................................................................................#
#..###...................................................................................................................#
#..#*#....####...####.....###..........####....####.....######.......#########.......######..######......................#
#**#*#.....#**#*#**#.....#***#.........#**##...#**#.....#*****##.....#*******#.........##**##**##........................#
#**#*#......#**#**#.....#**#**#........#****##.#**#.....#**##***#....#**#...............##****##.........................#
#**#.#........#**#.....#**#.#**#.......#**##..##**#.....#**##***#....#*******#........##***##***##.......................#
#**#.#.......#**#.....#**#####**#......#**#.##****#.....#*****##.....#**#...........##***##**##***##.....................#
####.########**#######**#.....#**#######**#...##**#######***##########*******#######***##......##***##...................#
#*......................................................................................................................?#
##########################################################################################################################
