##########################################################################################################################
#@*****?.................................................................................................................#
#........................................................................................................................#
#........................................................................................................................#
#........................................................................................................................#
#........................................................................................................................#
#........................................................................................................................#
#........................................................................................................................#
#........................................................................................................................#
#........................................................................................................................#
#........................................................................................................................#
#........................................................................................................................#
#........................................................................................................................#
#........................................................................................................................#
#........................................................................................................................#
#........................................................................................................................#
#........................................................................................................................#
#........................................................................................................................#
#........................................................................................................................#
#........................................................................................................................#
#........................................................................................................................#
#........................................................................................................................#
#........................................................................................................................#
#........................................................................................................................#
#........................................................................................................................#
#........................................................................................................................#
#........................................................................................................................#
##########################################################################################################################
