##########################################################################################################################
#@***....................................................................................................................#
#........................................................................................................................#
#........................................................................................................................#
#........................................................................................................................#
#........................................................................................................................#
#........................................................................................................................#
#........................................................................................................................#
#........................................................................................................................#
#........................................................................................................................#
#........................................................................................................................#
#........................................................................................................................#
#........................................................................................................................#
#........................................................................................................................#
#........................................................................................................................#
#........................................................................................................................#
#........................................................................................................................#
#........................................................................................................................#
#........................................................................................................................#
#........................................................................................................................#
#........................................................................................................................#
#........................................................................................................................#
#........................................................................................................................#
#........................................................................................................................#
#........................................................................................................................#
#........................................................................................................................#
#........................................................................................................................#
##########################################################################################################################