##########################################################################################################################
#@****...................................................................................................................#
#........................................................................................................................#
#........................................................................................................................#
#........................................................................................................................#
#........................................................................................................................#
#........................................................................................................................#
#........................................................................................................................#
#........................................................................................................................#
#........................................................................................................................#
#........................................................................................................................#
#........................................................................................................................#
#........................................................................................................................#
#........................................................................................................................#
#........................................................................................................................#
#........................................................................................................................#
#........................................................................................................................#
#........................................................................................................................#
#........................................................................................................................#
#........................................................................................................................#
#........................................................................................................................#
#........................................................................................................................#
#........................................................................................................................#
#........................................................................................................................#
#........................................................................................................................#
#........................................................................................................................#
#........................................................................................................................#
##########################################################################################################################