##########################################################################################################################
#@.?.....................................................................................................................#
#..?.....................................................................................................................#
#???.....................................................................................................................#
#........................................................................................................................#
#........................................................................................................................#
#........................................................................................................................#
#........................................................................................................................#
#........................................................................................................................#
#........................................................................................................................#
#........................................................................................................................#
#........................................................................................................................#
#........................................................................................................................#
#........................................................................................................................#
#........................................................................................................................#
#........................................................................................................................#
#........................................................................................................................#
#........................................................................................................................#
#........................................................................................................................#
#........................................................................................................................#
#........................................................................................................................#
#........................................................................................................................#
#........................................................................................................................#
#........................................................................................................................#
#........................................................................................................................#
#........................................................................................................................#
#........................................................................................................................#
##########################################################################################################################
